Ds1/Dt1/1
Dt1/Ds1/1
Cs1/Ct1/1
Ct1/Cs1/1
Bs1/Bt1/1
Bt1/Bs1/1
As1/At1/1
At1/As1/1
1s3/1t2/1
1t2/1s3/1
1t1/1s2/1
1s2/1t1/1
1t2/1t1/1
1t1/1t2/1
1t2/1i1/1
1i1/1t2/1
1i1/1s1/1
1s1/1i1/1
1s2/1i2/1
1i2/1s2/1
1i2/1s4/1
1s4/1i2/1
2t1/2s2/1
2s2/2s3/1
2s3/2t2/1
2t2/2i2/1
2i2/2s1/1
3s3/3s2/1
8s2/8s3/1
Ds1/Cs1/2
Cs1/Bs1/2
Bs1/As1/2
As1/1s3/2
1s2/2s2/2
1t1/2t1/1
1s1/2s1/2
1s4/2s4/2
2s1/3s1/2
2s4/3s4/2
2s3/3s3/2
2t2/3s3/1
3s1/4s1/2
3s2/4s2/2
3s4/4s3/2
4s1/5s1/2
4s2/5s2/2
4s3/5s3/2
5s1/6s1/2
5s2/6s2/2
5s3/6s3/2
6s1/7s1/2
6s2/7s2/2
6s3/7s3/2
7s2/8s2/2
7s1/8s1/2
7s3/8s4/2
8s1/9s1/2
8s3/9s2/2
8s4/9s3/2